[
	[],
	[	[ 0,    1,    2,    3,    4,    5,    6,    7,    8,    9,   10,   11,   12,   13],
		[ 1, "s1", "s2", "s3", "s4", "s5", "s6", "s7", "s8", "s9","s10","s11","s12", "d1"],
		[ 2, "s1", "d1", "w1", "w2", "w2", "w1", "w1", "w1", "w1",    0,    0, "s1", "s1"],
		[ 3, "s2", "w1",    0,    0,    0, "w1",    0, "w1",    0,    0, "w1",    0, "s1"],
		[ 4, "s3", "w2",    0,    0, "w1", "w1", "w1", "w1", "w1",    0,    0,    0, "w1"],
		[ 5, "s4", "w2",    0,    0,    0,    0, "w1",    0,    0,    0, "w1",    0,    0],
		[ 6, "s5", "s1",    0,    0, "w1",    0, "s1",    0, "w1",    0,    0,    0, "w1"],
		[ 7, "s6", "s1", "w1",    0,    0,    0, "w1",    0,    0,    0, "w1",    0,    0],
		[ 8, "s7",    0,    0,    0, "w1",    0,    0,    0, "w1",    0,    0,    0, "w1"],
		[ 9, "s8",    0, "w1",    0,    0,    0, "w1",    0,    0,    0, "w1",    0,    0],
		[10, "s9",    0,    0,    0, "w1",    0, "s1",    0, "w1",    0,    0,    0, "w1"],
		[11,"s10",    0, "w1",    0,    0,    0, "w1",    0,    0,    0, "w1",    0,    0],
		[12,"s11",    0,    0,    0,    0,    0,    0,    0, "w1",    0,    0,    0, "w1"],
		[13,"s12",    0,    0, "w1", "w1",    0, "w1",    0,    0,    0, "w1",    0,    0],
		[14, "d1",    0,    0,    0,    0,    0,    0,    0, "w1",    0,    0,    0, "w1"],
		[15, "s1", "s1", "w1",    0,    0,    0, "w1",    0,    0,    0, "s1", "s1", "s1"]
	],
	[[4, 4], [4, 12]],
	"_comments: ground, surface, player_pos。注意下标应从1开始，且逐列绘制，不是逐行！"
]