[
	[],
	[	[],
		[0, "s1", "s1", "s1", "s1", "s1",    0, "w1",    0,    0,    0, "w1", "s1", "s1"],
		[0, "s1", "s1", "s1",    0, "w1",    0,    0,    0, "w1",    0,    0, "s1", "s1"],
		[0, "s1", "s1",    0,    0,    0,    0, "w1",    0,    0,    0, "w1",    0, "s1"],
		[0, "s1", "s1",    0,    0, "w1",    0,    0,    0, "w1",    0,    0,    0, "w1"],
		[0, "s1", "s1", "w1",    0,    0,    0, "w1",    0,    0,    0, "w1",    0,    0],
		[0, "s1", "s1",    0,    0, "w1",    0, "s1",    0, "w1",    0,    0,    0, "w1"],
		[0, "s1", "s1", "w1",    0,    0,    0, "w1",    0,    0,    0, "w1",    0,    0],
		[0, "s1",    0,    0,    0, "w1",    0,    0,    0, "w1",    0,    0,    0, "w1"],
		[0,    0,    0, "w1",    0,    0,    0, "w1",    0,    0,    0, "w1",    0,    0],
		[0, "w1",    0,    0,    0, "w1",    0, "s1",    0, "w1",    0,    0,    0, "w1"],
		[0,    0,    0, "w1",    0,    0,    0, "w1",    0,    0,    0, "w1",    0,    0],
		[0, "w1",    0,    0,    0, "w1",    0,    0,    0, "w1",    0,    0,    0, "w1"],
		[0,    0,    0, "w1",    0,    0,    0, "w1",    0,    0,    0, "w1",    0,    0],
		[0, "w1",    0,    0,    0, "w1",    0,    0,    0, "w1",    0,    0,    0, "w1"],
		[0, "s1", "s1", "w1",    0,    0,    0, "w1",    0,    0,    0, "s1", "s1", "s1"]
	],
	[[4, 4], [4, 12]],
	"_comments: ground, surface, player_pos。注意下标应从1开始，且逐列绘制，不是逐行！"
]