[
	[],
	[	[ 0,    1,    2,    3,    4,    5,    6,    7,    8,    9,   10,   11,   12,   13],
		[ 1, "s1", "s1", "s1", "s1", "s1",    0,    0,    0,    0,    0, "w1", "s1", "s1"],
		[ 2, "s1", "s1", "s1",    0, "w1", "w1", "w1", "w1", "w1",    0,    0, "s1", "s1"],
		[ 3, "s1", "s1",    0,    0,    0, "w1",    0, "w1",    0,    0, "w1",    0, "s1"],
		[ 4, "s1", "s1",    0,    0, "w1", "w1", "w1", "w1", "w1",    0,    0,    0, "w1"],
		[ 5, "s1", "s1", "w1",    0,    0,    0, "w1",    0,    0,    0, "w1",    0,    0],
		[ 6, "s1", "s1",    0,    0, "w1",    0, "s1",    0, "w1",    0,    0,    0, "w1"],
		[ 7, "s1", "s1", "w1",    0,    0,    0, "w1",    0,    0,    0, "w1",    0,    0],
		[ 8, "s1",    0,    0,    0, "w1",    0,    0,    0, "w1",    0,    0,    0, "w1"],
		[ 9,    0,    0, "w1",    0,    0,    0, "w1",    0,    0,    0, "w1",    0,    0],
		[10, "w1",    0,    0,    0, "w1",    0, "s1",    0, "w1",    0,    0,    0, "w1"],
		[11,    0,    0, "w1",    0,    0,    0, "w1",    0,    0,    0, "w1",    0,    0],
		[12, "w1",    0,    0,    0,    0,    0,    0,    0, "w1",    0,    0,    0, "w1"],
		[13,    0,    0,    0, "w1", "w1",    0, "w1",    0,    0,    0, "w1",    0,    0],
		[14, "w1",    0,    0,    0,    0,    0,    0,    0, "w1",    0,    0,    0, "w1"],
		[15, "s1", "s1", "w1",    0,    0,    0, "w1",    0,    0,    0, "s1", "s1", "s1"]
	],
	[[4, 4], [4, 12]],
	"_comments: ground, surface, player_pos。注意下标应从1开始，且逐列绘制，不是逐行！"
]